Все чит-коды для ГТА Сан Андреас
Коды на оружие в GTA San Andreas \n
LXGIWYL  — набор оружия №1 (кастет, бита, пистолет 9mm, дробовик, пистолет-пулемёт micro SMG, автомат AK-47, винтовка, ракетница, коктейль Молотова, баллончик с краской)
KJKSZPJ  — набор оружия №2 (нож, пистолет Desert Eagle, дробовик обрез, пистолет-пулемёт Tec-9, автомат M4, снайперская винтовка, огнетушитель, огнемет, гранаты)
UZUMYMW  — набор оружия №3 (бензопила, пистолет с глушителем, боевой дробовик, автомат MP5, автомат M4, ракетница Stinger, взрывчатка с детонатором)
WANRLTW  — бесконечные пули, без перезарядки
AIYPWZQP  — получить парашют
NCSGDAG  — Hitman по всем параметрам оружия
Коды на здоровье и бессмертие \n
HESOYAM  — здоровье, броня, $250.000
BAGUVIX  — бесконечное здоровье
Чит-код на деньги
HESOYAM  — здоровье, броня, $250.000
Коды на машины
AIWPRTON  — получить танк (Rhino)
AKJJYGLC  — получить квадроцикл (Quad)
KGGGDKP  — получить маленькая воздушная подушка (Vortex overcraft)
AMOMHRER  — получить трейлер с топливом (Tanker Truck)
EEGCYXT  — получить бульдозер (Dozer)
AGBDLCID  — получить большой джип (Monster)
CQZIJMB — получить старая гоночная машина (Bloodring Banger)
JQNTDMH  — получить маленький джип (Rancher)
PDNEJOH  — получить гоночную машину 1 (Racecar)
VPJTQWV — получить гоночную машину 2 (Racecar)
AQTBCODX  — получить гробовозка (Romero)
KRIJEBR  — получить лимузин (Stretch)
UBHYZHQ  — получить мусоровоз (Trashmaster)
RZHSUEW  — получить гольф машинка (Caddy)
Коды на самолеты
OHDUDE  — получить военный вертолет (Hunter)
JUMPJET  — получить истребитель (Hydra)
URKQSRK  — получить кукурузник (Stunt Plane)
Коды на спецтехнику
JUMPJET  — получить Hydra
KGGGDKP  — получить Vortex Hovercraft
YECGAA  — получить Jetpack
Коды уровень розыска полиции
OSRBLHH  — увеличить на две звезды уровень вашей преступности
ASNAEB  — очистить уровень вашей преступности
AEZAKMI  — вас никогда не разыскивают
LJSPQK  — уровень вашей преступности — 6 звезд
Коды на поведение прохожих
IOJUFZN  — режим бунта
PRIEBJ  — тема — дурдом
ASBHGRB  — Elvis'ы повсюду
BGLUAWML  — пешеходы атакуют друг друга с ракетницами
CIKGCGX  — пляжная вечеринка
MROEMZH  — члены банды повсюду
BIFBUZZ  — члены банды контролируют улицу
AFPHULTL  — тема ниндзя
BEKKNQV  — магнит для девушек
FOOOXFT  — у всех есть оружие
AJLOJYQY  — пешеходы бьют друг друга
BAGOWPG  — рай у вас над головой
Коды на изменение городского транспорта и трафика
YLTEICZ  — агрессивные водители
CPKTNWT  — взорвать все машины
XICWMD — невидимая машина
PGGOMOY  — идеальное управление
SZCMAWO  — самоубийство
ZEIIVG  — все светофоры зеленые
BGKGTJH  — по улицам ездят только дешевые авто
GUSNHDE  — по улицам ездят только дорогие авто
RIPAZHA  — машины летают
JHJOECW  — большой заячий прыжок
LLQPFBN  — розовые авто
IOWDLAC  — черные авто
AFSNMSMW  — летающие лодки
JCNRUAD  — взрыв (Smash n' Boom)
COXEFGU  — у всех машин установлены нитроускорители
BSXSGGC  — машины отлетают при ударах
VQIMAHA  — все параметры вашей машины по максимуму
VKYPQCF  — у всех такси ест нитро
BMTPWHR  — сельские машины и пешеходы
MUNASEF  — режим — адреналин
OUIQDMW  — полный боекомплект при вождении
THGLOJ  — уменьшенный трафик на улицах
FVTMNBZ  — по городу ездят только сельские машины
Коды на характеристики героя
BTCDBCB  — толстяк
JYSDSOD  — качек
KVGYZQK  — худой
ZSOXFSQ  — завербовать кого-то (Rockets)
OGXSDAG  — максимум уважения
EHIBXQS — максимум привлекательности
AEDUWNV  — никогда не голоден
SJMAHPE  — завербовать кого-то (9mm)
LFGMHAL  — мега прыжок
CVWKXAM  — бесконечный кислород
IAVENJQ  — мега удар
Коды на погоду
AFZLLQLL  — солнечная погода
ICIKPYH  — очень солнечная погода
ALNSFMZO  — облачная погода
AUIFRVQS  — дождливая погода
CFVFGMJ  — туман
XJVSNAJ  — всегда полночь
OFVIAC  — оранжевое небо (21:00)
MGHXYRM  — гроза
CWJXUOC  — песчаный шторм
Коды на время
YSOHNUL  — ускорить время
PPGWJHT  — ускоренная игра
LIYOAAY  — замедленная игра